1111111111111
10010000000C1
100C011111001
1P0011E0000M1
1010Z11110001
1001000000001
1111111111111