1111111111111
10010000000C1
100C011111001
1P0011E000M1
1010011110001
10010000001
1111111111111