1111111111111
1000E010000C1
1P00110000C01
1010010110001
1001000M00001
1111111111111

