11111111111111
1000E010000C01
1P00110000C001
10000101100001
10010000000001
10000000000001
1001000M000001
11111111111111